04040404
10101010
01010101
10101010
01010101
10101010
01010101
90101010
