02020202
00000000
00000000
00000000
00000000
00000000
00000000
10000000
