04040404
00000000
00000000
00000000
00000000
00000000
00000000
10000000
